100
100
PPPPPPPPPPPPPPPPPPPPPPPPPPPPPPPPPPPPPPPPPPPPPPPPPPPPPPPPPPPPPPPPPPPPPPPPPPPPPPPPPPPPPPPPPPPPPPPPPPPP
PPPPPPPPPPPPPPPPPPPPPPPPPPPPPPPPPPPPPPPPPPPPPPPPPPPPPPPPPPPPPPPPPPPPPPPPPPPPPPPPPPPPPPPPPPPPPPPPPPPP
PPPPPPPPPPPPPPPPPPPPPPPPPPPPPPPPPPPPPPPPPPPPPPPPPPPPPPPPPPPPPPPPPPPPPPPPPPPPPPPPPPPPPPPPPPPPPPPPPPPP
PPPAAAAAAAAAAAAAAAAAAAAAAAAAAAAAAAAAAASSAAAAAAAAAASSAAAASSAAAAAAAAAAAAAAAAAAAASSAAAAASSAAAKASSASSPPP
PPPAAAAAAAAAAAAAAAAAAAAAAAAASAAAAAAAAAASSAAAAAAAASSSSASSSSAAAAAAAAAAAAAAAAAAAASSAAAAASSAAAASSASSAPPP
PPPAAAAAAAAAAAAAAAAAAAAAAASSSSAAAAAAAAASSAAAAAAAASSSSSSSAAAAAAAAAAAAAAAAAAAAASSAAAAASSAAAAAASSAAAPPP
PPPAAAAAAAAAAAAAAAAAAAAASSSSASSSSAAASASSSASASSASSSSAASAAAAAAAAAAAAAAAAAAAAAAAASSAAAASSAAAAAAASSAAPPP
PPPAAAAAAAAAAAAAAAAAAAASSSAAAASSSSSSSSSSASSSSSSSSASSAAAAAAAAAAAAAAAAAAAAAAAAAASSAAAAASSAAAAAASSAAPPP
PPPAAAAAAAAAAASAAAAAASSSAAAAAAAAASSSASASSSASAASAASSAAAAAAAAAAAAAAAAAAAAAAAAAAAASSAAASSAAAAAAASSAAPPP
PPPAAAAAAAAAASSSASSSSSSAAAAAAAAAAAAAAAAASAAAAAAAAASSAAAAAAAAAAAAAAAAAAAAAAAAAAASSAASSAAAAAAAAASSAPPP
PPPAAASSAAAASSASSSSSSAAAAAAAAAAAAAAAAAAASSAAAAAAAAASSAAAAAAAAAAAAAAAAAAAAAAAAAAASSASSAAAAAAAASSSSPPP
PPPSASSSSASSSAAASAAAAAAAAAAAAAAAAAAAAAAASSAAAAAAAAASSAAAAAAAAAAAAAAAAAAAAAAAAAAASSAASSAAAAAAAASSAPPP
PPPSSSAASSSSAAAAAAAAAAAAAAAAAAAAAAAAAAAASSAAAAAAAASSAAAAAAAAAAAAAAAAAAAAAAAAAAAAASSSSSSSSSSSSSSSAPPP
PPPASAAAASAAAAAAAAAAAAAAAAAAAAAAAAAAAAAAASSAAAAAAAASSAAAAAAAAAAAAAAAAAAAAAAAAAAASSASSSMMMMMMMMMSAPPP
PPPAAAAAAAAAAAAAAAAAAAAAAAAAAAAAAAAAAAAAAASSAAAAAAASSAAAAAAAAAAAAAAAAAAAAAAAAAASSAAAASMSSSSSSSMSAPPP
PPPAAAAAAAAAAAAAAAAAAAAAAAAAAAAAAAAAAAAAAASSAAAAAASSAAAAAAAAAAAAAAAKAAAAAAAAAAAAAAAAASMSSSSSSSMSAPPP
PPPAAAAAAAAAAAAAAAAAAAAAAAAAAAAAAAAAAAAAAAASSAAAAASSAAAAAAAAAAAAAAAAAAAAAAAAAAAAAAAAASMSSSSSSSMSAPPP
PPPAAAAAAAAAAAAAAAAAAAAAAAAAAAAAAAAAAAAAAAASSAAAAASSAAAAAAAAAAAAAAAAAAAAAAAAAAASSAAAASMSSSSSSSMSAPPP
PPPAAAAAAAAAAAAAAAAAAAAAAAAAAAAAAAAAAAAAAASSAAAAAASSAAAAAAAAAAAAAAAAAAAAAAAAAAAASSAAASMSSSSSSSSSAPPP
PPPAAAAAAKAAAAAAAAAAAAAAAAAAAAAAAAAAAAAAAASSAAAAAAASSAAAAAAAAAAAAAAAAAAAAAAAAAAAASSAASMSSSSSSSMSAPPP
PPPAAAAAAAAAAAAAAAAAAAAAAAAAAAAAAAAAAAAAASSAAAAAAAASSAAAAAAAAAAAAAAAAAAAAAAAAAAAASSAASMSSSSSSSMSAPPP
PPPAAAAAAAAAAAAAAAAAAAAAAAAAAAAAAAAAAAAAKASSAAAAAAAASSAAAAAAAAAAAAAAAAAAAAAAAAAASSAAASMMMSMMMMMSAPPP
PPPAAAAAAAAAAKTTTTTTTKAAAAAAAAAAAAAAAAAAAAASSAAAAAASSAAAAAAAAAAAAAAAAAAAAAAAAAAAASSAASSSSSSSSSSSAPPP
PPPKAAAAAAAAATTTTTTTTTAAAAAAAAAAAAAAAAAAAASSAAAAAASSAAAAAAAAAAAAAAAAAAAAAAAAAAAAASSASSAAAAAAAASSAPPP
PPPAAAAAAAAAATTTTTTTTTAAAAAAAAAAAAAAAAAAAAASSAAAAAASSAAAAAAAAAAAAAAAAAAAAAASSSSSSSSSSSAAAAAAASSAAPPP
PPPAAAAAAAAAATTTTTTTTTAAAAAAAAAAAAAAAAAAAAASSAAAAAASSAAAAAAAAAAAAAAAAAAAAAASMMMMMMMMMSAAAAAAASSAAPPP
PPPAAAAAAAAAATTTTTTTTTAAAAAAAAAAAAAAAAAAAAAASSAAAAASSAAAAAAAAAAAAAAAAAAAAAASMSSSSSSSSSAAAAAAAASSAPPP
PPPAAAAAAAAAATTTTTTTTTAAAAAAAAAAAAAAAAAAAAAAASSAAAASSAAAAAAAAAAAAAAAAAAAAAASMSSSSSSSMSAAAAAAAASSAPPP
PPPAAAAAAAAAATTTTTTTTTAAAAKAAAAAAAAAAAAAAAAAAASSAAASSAAAAAAAAAAAAAAAAAAAAAASMSSSSSSSMSAAAAAAASSAAPPP
PPPAAAAAAAAAATTTTTTTTTAAAAAAAAAAKAAAAAAAAAAAASSAAASSAAAAAAAAAAAAAAAAAAAAAAASMSSSSSSSMSAAAAAAAASSAPPP
PPPAAAAKAAAAATTTTTTTTTAAAAAAAAAAAAAAAAAAAAAAASSAAASSAAAAAAAAAAAAAAAAAAAAAAASMSSSSSSSMSAAAAASAASSAPPP
PPPAAAAAAAAAATTTTTTTTTAAAAAAAAAAAAAAAAAAAAAAASSAAAASSAAAAAAAAAAAAAAAAAAAAAASSSSSSSSSMSAAASSSSSSSSPPP
PPPAAAAAAAAAATTTTTTTTTAAAAAAAAAAAAAAAAAAAAAAASSAAAAASSAAAAAAAAAAAAAAAAAAAAASMSSSSSSSMSAASSSASSSAAPPP
PPPAAAAAAAAAATTTTTTTTTAAAAAAAAAAAAAAAAAAAAAAAASSAAAAASSAAAAAAAAAAAAAAAASKSSSMMMMMMMMMSSSSAAAASSAAPPP
PPPAAAAAAAAAATTTTTTTTTAAAAAAAAAAAAAAAAAAAAAAASSAAAAAASSAAAAAAAAAAAAAASSSSSSSSSSSSSSSSSSSAAAASSAAAPPP
PPPSSAAAASSSAKTTTTTTTKAAAAAAAAAAAAAAAAAAAAAAASSAAAAAAASSAAAAAAAAAAAASSSASAAAAAAAAASSSSAAAAAAASSAAPPP
PPPSSSAASSSSSSSSSSSAASSAAAAAAASAAAAAAAAAAAAASSAAAAAAASSAAAAAAAAAAAASSAAAAAAAAAAAAASSSSAAAAAAASSAAPPP
PPPAASSSSAAASAASSSSSSSSSSSASSSSSSASAAAAAAAAASSSAAAAAAASSAAAAAAAASASSAAAAAAAAAAAAASSAASSAAAAAAASSAPPP
PPPAAASSAAAAAAAAAAASSAASSSSSSSASSSSSSASASAASSSSSAAAAAAASSAAASAASSSSAAAAAAAAAAAAAAASSSSAAAAAAASSAAPPP
PPPAAAAAAAAAAAAAAAAAAAAAAASAAAAAASASSSSSSSSSSSASSSSSSASSAASSSSSSASAAAAAAAAAAAAAAAAAASSAAAAAAASSAAPPP
PPPAAAAAAAAAAAAAAAAAAAAAAAAAAAAAAAAAASASASSSSAAASSSSSSSSASSSASSAAAAAAAAAAAAAAAAAAAASSSSAAAAASSAAAPPP
PPPAAAAAAAAAAAAAAAAAAAAAAAAAAAAAAAAAAAAAAASSAAAAAAAAASBSSSBBBBBBBBBBAAAAAAAAAAAAAAAASSAAAAAAASSAAPPP
PPPAAAAAAAAAAAAAAAAAAAAAAAAAAAAAAAAAAAAAASSAAAAASSSSSSSSSSSBBBBBBBBBAAAAAAAKABBBBBBBSSBBBAAAAASSAPPP
PPPAAAAAAAAAAAAAAAAAAAAAAAAAAAAAAAAAAAAAAASSAAAASMMMMMMSMMSBBBBBBBBBAAAAAAAAABBBBBBBSSBBBAAAASSAAPPP
PPPAAAAAAAAAAAAAAAAAAAAAAAAAAAAAAAAAAAAAAAASSAAASMSSSSSSSMSBBBBBBBBBBBAABBBBBBBBBBBSSSSBBAAASSAAAPPP
PPPAAAAAAAAAAAAAAAAAAAAAAAAAAAAAAAAAAAAAAASSAAAASMSSSSSSSMSBBBBBBBBBBBBAABBBBBBBBBBSSBSSBAASSAAAAPPP
PPPAAAAAAAAAAAAAAAAAAAAAAAAAAAAAAAAAAAAAASSKAAAASMSSSSSSSMSBBBBBBBBBBBBAABBBBBBBBBSSBBBSSAAASSAAAPPP
PPPAAAAAAAAAAAAAAAAAAAAAAAAAAAAAAAAAAAAAAASSAAAASMSSSSSSSMSBBBBBBBBBBBBBAABBBBBBBBBSSBBSSAAASSAAAPPP
PPPAAAAAAAAAAAAAAAAAAAAAAAAAAAAAAAAAAAAAAAASSAAASMSSSSSSSMSBBBBBBBBBBBBBAABBBBBBBBSSBBBSSAAAASSAAPPP
PPPAAAAAAAAAAAAAAAAAAAAAAAAAAAAAAAAAAAAAAAASSAAASMSSSSSSSMSBBBBBBBBBBBBAABBBBBBBBBSSBBBSSAAAAASSAPPP
PPPAAAAAAAAAAAAAAAAAAAAAAAAAAAAAAAABBBBBBBSSBBBBSMSSSSSSSMSBBBBBBBBBBBBBAABBBBBBBBSSBBBSSAAAAKASSPPP
PPPAAAAAAAAAAAAAAAAAAAAAAAAAAAAASAABBBBBBBBSSBBBSMMMMMMMMMSBBBBBBBBBBBBBBAABBBBBBBBSSBSSBAAAAAASSPPP
PPPAAAAAAAAAAAAAAAAAAAAAAAAAASASSSASBBBBBBSSBBBBSSSSSSSSSSSBBBBBBBBBBBBBBAABBBBBBBBBSSSSBAAAAAASSPPP
PPPAAAAAAAAAAAAAAAAAAAASSASSSSSSASSSSSBSBSSBSBBBBAAAAABBSSBBBBBBBBSBBBBBAABBBBBBBBSBBSSBBASSSSSASPPP
PPPASAAAAAAAAAAAAAAAASSSSSSSSASAAASBSSSSSBBSSSSBBASASABBBSSBBSBSBSSSBBBAABBBBKBBBSSSSSASASSSSSSSSPPP
PPPSSSAABSBBBBSSSBAASSSAASAAAAAAAAABBBSBSSSSBSSSBSSSSSAAASSASSSSSSASSBBBSBBSSSSSSSBSASSSSSAAAAASAPPP
PPPSASSASSSSSSSSSSSSSAAAAAAAAAAAAAABBBBBBSSBBBBSSSASASSSASSSSASASAAASSSSSSSSSSSSSBBBSSAASAAAAAAAAPPP
PPPSASSSSSSSSSSBBSSSAAAAAAAAAAAAAAABBBBBSSBBBBBBSAAAAASSSSASAAAAASASSSSSBSSSBBBBBBBBASAAAAAAAAAAAPPP
PPPSSSASBSBBBBSSBBAAAAAAAAAAAAAAAAABBBBSSBBBBBBBBAAAAAASSAAAAAAASSSSSBBBAABSSBBBSBBBSSSAAASSAAAAAPPP
PPPASAAABBBBBBBSSSAAAAAAAAAAAAAASAABBBBBSSBBBBBBBAAAAAAASSAAAAASSASABBBBBAABSSBSSSBSSASSSSSSSAAAAPPP
PPPAAAAABBBBBBBBSSSAAAAAAAASSASSSSABBBBBBSSBBBBBBAAAAASASSAAASSSAAAAAAAAAAAAASSSASSSSSASSSAASSAAAPPP
PPPAAAAABBBBBBBBBBSSASSSAASSSSSSASSBBBBBSSBBBBBBBAAAASSSASSASSSSAAAAAAAAAAAAAASAAASAASSAAAAAASSASPPP
PPPAAAAABBBBBBBBBBASSSSSSSSAASAAAASSBBBBBSSBSSBBBSAASSASSSSSSSSSSSAAASSSAASSASSASSAAASSASAASSASSSPPP
PPPAAAAABBBBBBBBBBAASAAASSAAAAAAAAASSSSSSSBSSSBSSSSSSSSASSSSSSSASSSSSSSSAASSSSSSSSSSASSSSSSSSAASSPPP
PPPAAAAABBBBBBBBBBAAAAAAAAAAAAAAAAAASSSSASSSAASSSASSASSSASSSSAAAAASSSAAAAAAASAASAASSSSSSASSAAAAASPPP
PPPAAAAAAAAAAAAAAAAAAAAAAAAAAAAAAAAAAAAAASSAASSAAAAAAAASSSASAAAAAAAAAAAAAAAAAAAAAAAASSSAAAAAAAAAAPPP
PPPAKAAAAAAAAAAAAAAAAAAAAAAAAAAAAAAAAAAAASSSSSAAAAAAAAASSAAAAAAAAAAAAAAAAAAAAAAAAAAAAASSAAAAAAAAAPPP
PPPAAAAAAAAAAAAAAAAAAAAAAKAAAAAAAAAAAAAAABSSSBBBBBBBBBBBSSAAAAAAAAAAAAAAAAAAAAAAAAAAASSSSAAAAAAAAPPP
PPPASAAAAAAAAAAAAAAAAAAAAAAAAAAAAAAAAAAAASSBBBBBBBBBBBBSSAAAAAAAAAAAAAAAAAAAAAAAAAAAAASSAAAAAAAAAPPP
PPPSSSSAAAAAAAAAAAAAAAAAAAAAAAAAAAAAAAAASSSSBBBBBBBBBBBBSSAAAAAAAAAAAAAAAAAAAAAAAAAAASSAAAAAAAAAAPPP
PPPSASSSASASAAAAAAAAAAAAAAAAAAAASAAAAASSSKSSBBBKBBBBBBBSSAAAAAAAAAAAAAAAAAAAAAAAAAAASSSSAAAAAAAAAPPP
PPPAAAASSSSSSAASSSSSSSSSSSSSAAASSSSASSSSASSBBBBBBBBBBBBSSAKAAAAAAAAAAAAAAAAAAAAAAAAAASSAAAAAAAAAAPPP
PPPAAAAASASASSSSMMMMMMMMMSSSSSSSASSSSSAASSBBBBBBBBBBBBBSSAAAAAAAAAAAAAAAAAAAAAAAAAAAASSAAAAAAAAAAPPP
PPPAAAAAAAAAASSSMSSSSSSSMSAASSSAAAASAAKSSBBBBBBBBBBBBBBSSAAAAAAAAAAAAAAAAAAAAAAAAAAAASSAAAAAAAAAAPPP
PPPAAAAAAAAAAAASMSSSSSSSMSAAAAAAAAAAAAASSBBBBBBBBBBBBBSSBAAAAAAAAAAAAAAAAAAAAAAAAAAAASSAAAAAAAAAAPPP
PPPAAAAAAAAAAAASMSSSSSSSMSAAAAAAAAAAAAAASSBBBBBBBBBBBSSBBAAAAAAAAAAAAAAAAAAAAAAAAAAAAASSAAAAAAAAAPPP
PPPAAAAAAAAAAAASSSSSSSSSSSAAAAAAAAAAAAASSBBBBBBBBBBBSSBBBAAAAAAAAAAAAAAAAAAKAAAAAAAAASSAAAAAAAAAAPPP
PPPAAAAAAAAAAAASMSSSSSSSMSAAAAAAAAAAAAASSBBBBBBBBBBBBSSBBAAAAAAAAAAAAAAAAAAAAAAAAAAASSAAAAAAAAAAAPPP
PPPAAAAAAAAAAAASMSSSSSSSMSAAAAAAAAAAAASSABBBBBBBBBBBBBSSBAAAAAAAAAAAAAAAAAAAAAAAAAAASSAAAAAAAAAAAPPP
PPPAAAAAAAAAAAASMSSSSSSSMSAAAAAAAAAAASSAAKBBBBBKBBBBBSSBBAAAAAAAAAAAAAAAAAAAAAAAAAAAASSAAAAAAAAAAPPP
PPPAAAAAAAAAAAASMMMMMMMMMSAAAAAAAAAAASSAABBBBBBBBBBBBBSSBAAAAAAAAAAAAAAAAAAAAAAAAAAAAASSAAAAAAAAAPPP
PPPAAAAAAAAAAAASSSSSSSSSSSAAAAAAAAAASSAAABBBBBBBBBBBBBSSBAAAAAAAAAAAAAAAAAAAAAAAAAAAASSAAAAAAAAAAPPP
PPPAAAAAAAAAAAAAAAAAAAAAAAAAAAAAAAAASSAAABBBBBBBBBBBBSSBBAAAAAAAAAAAAAAAAAAAAAAAAAAAASSAAAAAAAAAAPPP
PPPAAAAAAAAAAAAAAAAAAAAAAAAAAAAAAAAASSAAAAAAAAAAAAAASSAAAAAAAAAAAAAAAAAAAAAAAAAAAAAAASSAAAAAKAAAAPPP
PPPAAAAAAAAAAAAAAAAAAAAAAAAAAAAAASSSSSSSSSSSAAAAAAASSAAAAAAAAAAAAAAAAAAAAAAAAAAAAAAAASSAAAAAAAAAAPPP
PPPAAAAAAAAAAAAAAAAAAAAAAAAAAAAAASMSMMMMMMMSAAAAAAAASSAAAASAAAAAAAAAAAAAAAAAAAAAAAAAAASSAAAAAAAAAPPP
PPPASAAAAAAAAAAAAAAAAAAAAAAAAASSSSMSSSSSSSMSASAAASASASSSASSSASAAAAAAAAAAAAAAAASSAAAAASSAAAAAAAAAAPPP
PPPSSSAAAAAAAAAAAAAAAAAAAASASSSSSSMSSSSSSSMSSSSASSSSSSASSSASSSSAAAAAAAAASAAAASSSSAAAAASSAAAAAAAAAPPP
PPPSASSSAAAAAAAASAAAAAAAASSSSSAAASMSSSSSSSMSSASSSASSSAAASAAASASSSASSAAASSSAASSAASSAAASSSSAAAASASAPPP
PPPAAASSSAAAAASSSSASAAAASSASAAKAASMSSSSSSSMSAAASAAASSAAAAAAAAAASSSSSSSSSASSSSAAAASSAAASSSSSSSSSSSPPP
PPPAAAAASSSASSSSASSSSSASSAAAAAAAASMSSSSSSSMSAAAAAASSAAAAAAAAAAAAASAASSSAAASSAAAAAASSASSSSSSSSASASPPP
PPPAAAAAASSSSSAAAASASSSSAAAAAAAAASMSSSSSSSMSAAAAASSAAAAAAAAAAAAAAAAAAAAAAAAAAAAAAAASSSSSSSAAAAAAAPPP
PPPAAAAAAAASAAAAAAAAAASAAAAAAAAAASMSSSSSSSMSAAAAASSAAAAAAAAAAAAAAAAAAAAAAAAAAAAAAAAASASSSSAAAAAAAPPP
PPPAAAAAAAAAAAAAAAAAAAAAAAAAAAAAASMMMMMMSMMSAAAAAASSAAAAAAAAAAAAAAAAAAAAAAAAAAAAAAAAASSASSAAAAAAAPPP
PPPAAAAAAAAAAAAAAAAAAAAAAAAAAAAAASSSSSSSSSSSAAAAASSAAAAAAAAAAAAAAAAAAAAAAAAAAAAAAAAASSASSAAAAAAAAPPP
PPPAAAAAAAAAAAAAAAAKAAAAAAAAAAAAAAASSAAAAAAAAAAAAASSAAAAAAAAAAAAAAAAAAAAAAAAAAAAAAASSASSAAAAAAAAAPPP
PPPAAAAAAAAAAAAAAAAAAAAAAAAAAABBBBBBSSBBAAAAAAAAAAASSAAAAAAAAAAAAAAAAAAAAAAAAAAAAASSAAASSAAAAAAAAPPP
PPPPPPPPPPPPPPPPPPPPPPPPPPPPPPPPPPPPPPPPPPPPPPPPPPPPPPPPPPPPPPPPPPPPPPPPPPPPPPPPPPPPPPPPPPPPPPPPPPPP
PPPPPPPPPPPPPPPPPPPPPPPPPPPPPPPPPPPPPPPPPPPPPPPPPPPPPPPPPPPPPPPPPPPPPPPPPPPPPPPPPPPPPPPPPPPPPPPPPPPP
PPPPPPPPPPPPPPPPPPPPPPPPPPPPPPPPPPPPPPPPPPPPPPPPPPPPPPPPPPPPPPPPPPPPPPPPPPPPPPPPPPPPPPPPPPPPPPPPPPPP
