100
100
PPPPPPPPPPPPPPPPPPPPPPPPPPPPPPPPPPPPPPPPPPPPPPPPPPPPPPPPPPPPPPPPPPPPPPPPPPPPPPPPPPPPPPPPPPPPPPPPPPPP
PPPPPPPPPPPPPPPPPPPPPPPPPPPPPPPPPPPPPPPPPPPPPPPPPPPPPPPPPPPPPPPPPPPPPPPPPPPPPPPPPPPPPPPPPPPPPPPPPPPP
PPPPPPPPPPPPPPPPPPPPPPPPPPPPPPPPPPPPPPPPPPPPPPPPPPPPPPPPPPPPPPPPPPPPPPPPPPPPPPPPPPPPPPPPPPPPPPPPPPPP
PPPTTTTTTTTTTTTTTTTTTTTTTTTAATTSSTTTTTTTTTTTTTTTTTTTTTTTTTTTTSSTTTTTTSSTTTTTTTTTTTTTTTTTTTTTTTTTTPPP
PPPTTTTKTTTTTTTTTTTTTTTTTTTTAATTSSTTTTTTTTTTTTTTTTTTTTTTTTTTTTSSTTTTSSSSTTTTTTTTTTTTTTTTTTTTTTTTTPPP
PPPTTTTTTTTTTSSTTTTTTTTTTTTTAATTSSTTTTTTTTTTTTTTTTTTTTTTTTTTTTTSSTTTSSSSTTTTTTTTTTTTTTTTTTTTTTTTTPPP
PPPTTTSTSTSTSSSSTTTTTTTTTTTAATTTSSTTTTTTTTTTTTTTTTTTTTTTTTTTTTTTSSTTSSSSTTTTTTTTTTTTTTTTTTTTTTTTTPPP
PPPTTSSSSSSSSTTSSTTTTSSTTTAAKTTSSTTTTTTTTTTTTTTTTTTTTTTTTTTTTTTSSTTTSSTTTTTTTTTTTTTTTTTTTTTTTTTTTPPP
PPPPPSSPPPPPPPPSSPPPPPPPPPPPPPPPPPPPPPPPPPSSSTSTSTSTTTTTTTTTTTTSSTTSSSSTTTTTTTTTTTTTTTTTTTTTTTTTTPPP
PPPSSTTTTTTTTTTTTSSSSBBSSBSAASBBSBTTTTTTTTTTTTTTTTTTTTTTTTTTTTTTSSSSTSSTTTTTTTTTTTTTTTKTTTTTTTTTTPPP
PPPTTTTTTTTTTTTTTTSTBBBBSSSSSSSSSSSSTTTTTTTTTTTTTTTTTTTTTTTTTTTTTSSSSSSTTTTTTTTTTTTTTTTTTTTTTTTTTPPP
PPPTTTTTTTTTTTTTTTTTBBBBBSBSSBSSBSSSSTTTTTTTTTTTTTTTTTTTTTTTTTTTTSSSSSSTTTTTTTTTTTTTTTTTTTTTTTTTTPPP
PPPTTTTTTTTTTTTTTTTTBBBBBBBBAABSSBTTSSSTTTTTTTTTTTTTTSSSTTTTTTTTSSTSSSSTTTTTTTTTTTTTTTTTTTTTTTTTTPPP
PPPTTTTTTTTTTTTTTTTTBBBBBBBBAABBSSTTTSSSSSTTTTTTSSSSSSSSSSSSTSTSSSTSSTTTTTTTTTTTTTTTTTTTTTTTTTTTTPPP
PPPTTTTTTTTTTTTTTTTTBBBBBBBAABBBSSTTSTSSSSSSSSSSSSSSSSAASSSSSSSSSSSTSTSSSSSSSSSSSTSTTTTSSSSTTTTTTPPP
PPPTTTTTTTTTTTTTTTTTBSSSBBAASSBSSBSSSSSTTTSSSSSSTTTTTSAAAAAASTSSSSSSSSSMSMMMMMMMSSSTTTSSSSSSSTSTSPPP
PPPTTTTTTTTTTTSSSSSSSSSSSSAASSSBSSSSTSTTTTTTTTTTTTTTTAAAAAAAATTSTSSSTSSMSSSSSSSMSSSSSSSTTTTSSSSSSPPP
PPPTTTTTTTTTSSSSSSSSSBBBSSBAABSBSSTTTTTTTTTTTTTTTTTTTAAPPPPPPPPPPPPPPPPPPPPSPPPPPPPPPPPPPPPPPPTSTPPP
PPPTTTTTTTSSSSTTTTTTBBBBBBBBAABSSBTTTTTTTTTTTTTTTTTTTAAAAAAAATTTTTSSSSSMSSSSSSSMSTTTTTSSTTTTTTTTTPPP
PPPTTTTSSSSSTTTTTTTTBBBBBBBBBAABSSTTTTTTTTTTTTTTTTTTTAAAAAAAATTTTTSSTTSMSSSSSSSMSTTTTTTSSSTSTTTTTPPP
PPPSSSSSSSTTTTTTTTTTBBBBBBBBBBBSSBTTTTTTTTTTTTTTTTTTTAAAAAAAATTTTTTSSTSMSSSSSSSMSTTTTTTTSSSSSSTSTPPP
PPPSSSSTTTTTTTTTTTTTBBBBBBBBBBSSBBTTTTTTTTTTTTTTTTTTTAAAAAAAATTTTTTSSTSMSSSSSSSMSTTTTTTTTTSTSSSSSPPP
PPPTTTTTTTTTTTTTTTTTBBBBBBBBBBSSBBTTTTTTTTTTTTTTTTTTTTTTTTTTTTTTTTTTSSSMSSSSSSSMSTTTTTTTTTTTTTSTSPPP
PPPTTTTTTTTTTTTTTTTTTTTTTTTTTTKSSTTTKTTTTTTTTTTTTTTTTTTTTTTTTTTTTTTTSSSMMMMSMMMMSTTTTTTTTTTTTTTTTPPP
PPPTTTTTTTTTTTTTTTTTTTTTTTTTTTTSSTTTTTTTTTTTTTTTTTTTTTTTTTTTTTTTTTTTSSSSSSSSSSSSSTTTTTTTTTTTTTTTTPPP
PPPTTTTTTTTTTTTTTTTTTTTTTTTTTTTSSTTTTTTTTTTTTTTTTTTTTTTTTTTTTTTTTTTSSSSTTTTTTTTTTTTTTTTTTTTTTTTTTPPP
PPPTTTTTTTTTTTTTTTTTTTTTTTTTTTTSSTTTTTBBBBBBBBBBBBBBBBTTTTTTTTTTTTTTTSSTTTTTTTTTTTTTTTTTTTTTTTTTTPPP
PPPTTTTTTTTTTTTTTTTTTTTTTTTTTTSSTTTTTTBBBBBKBBBBBBBBBBTTTTTTTTTTTTTTSSSSTTTTTTTTTTTTTTTTTTTTTTTTTPPP
PPPTTTTTTTTTTTTTTTTTTTTTTTTTTTTSSTTTTTBBBBBBBBBBBBBBBBTTTTTTTTTTTTTTTSSSSTTTKTTTTTTTTTTTTTTTTTTTTPPP
PPPTTTTTTTTTTTTTTTTTTTTTTTTTTTSSTTTTTTBBBBBBBBBBBBBBBBTTTTSSSSSSSSSSSTSSSSTTTTTTTTTTTTTTTTTTTTTTTPPP
PPPMMMMMMMMMMMMMMMTMMMMMMMMMMMMMMMMMMMMMMMMMMMMMMMMMMMMMMMMMMMMMMSMMMMMMMMMMMMMMMMMMMMMMMMMMMMMMMPPP
PPPSSSSSSTTTTTTTTTTTTTTTTTTTSSAATTTTTTBBBBBBBBBKBBBBBBTTTTSMSSSSSSSMSSSTTTSSTTTTTTTTTTTTTTTTTTTTTPPP
PPPTSSTTSSTTTTTTTTTTTTTTTTTTTSSTTTTTTTBBBBBBBBBBBBBBBBTTTTSMSSSSSSSMSSSTTTTSSTTTTTTTTTTTTTTTTTTTTPPP
PPPTTTTTTSSTTTTSSSTTTTTTTTTTSSTTTTTTTTBBBBBBBBBBBBBBBBTTTTSMSSSSSSSMSTSSSTSSTTTTTTTSTTTTTTTTTTTTTPPP
PPPTTTTTTTSSSSSSSSSTTTTTTTTSSAATTTTSTSSBBBBBBBBBBBBBBBSTTTSMSSSSSSSMSTTSSSSSSSTTSTSSSTTTTTTTTTTTTPPP
PPPTTTTTTTTSSSSTTTSSSSSTTTTTSSAATTSSSSSSBBBBBBBBBBBBBSSSSSSMSSSSSSSMSTSSTSSSSSSSSSSTSSTSTTSSSSTTTPPP
PPPTTTTTTTSTTTTTTTTSSSSSTTSTSSTAASSTSTBSSSBBSSBBBBBBSSTSSSSMSSSSSSSSSSSTSSTTTTSSTSTTTSSSSSSSSSSSSPPP
PPPTTTTTTSSSTTTTTTTTTTTSSSSSSTSTSSTTTTBBSSSSSSSSBBBSSBTTTTSMSSSSSSSMSSSSSSTTTTTTTTTTTTSTSSTTTTSSSPPP
PPPSTTTSSSTSSTSTTTTTTTTTSSTSSSSSSTTTTTBBBBSSBBSSSSSSBBTTTTSMMMMMMMMMSTTSSTTTTTTTTTTTTTTTTTTTTTTTTPPP
PPPSSSSSSTTTSSSSSTSTTSTTTTTTTSTSAATTTTBBBBBBBBBBSSSBBBTTTTSSSSSSSSSSSTSSSSTTTTTTTTTTTTTTTTTTTTTTTPPP
PPPTSSSTTTTTTSTSSSSSSSSSSTTTSSTAATTTTTBBBBBBBBBBBBBBBBTTTTTTTTTTTTTTSSTSSSSTTTTTTTTTTTTTTTTTTTTTTPPP
PPPTTTTTTTTTTTTTTSTSSTSSSSTTSSSTAATTTTBBBBBBBBBBBBBBBBTTTTTTTTTTTTTSSTSSTSSTTTTTTTTTTTTTTTTTTTTTTPPP
PPPTTTTTTTTSSSSSSSSSSSTTTSSSSSSSAASTTTTTTTTTTTTTTTTTTTTTTTTTTTTTTTTTSSTSSSSTTTTTTTTTTTTTTTTTTTTTTPPP
PPPTTTTTTTTSMMMMMMMMMSTTTTSSSSTSSSSSTTTTTTTTTTTTTTTTTTTTTTTTTTTTTTTTSSTTSSTTTTTTTTTTTTTTTTTTTTTTTPPP
PPPTTTTTTTTSMSSSSSSSMSTTTTTSSTTTSSTSSSTSTTTTTTTTTTTTTTTTTTTTTTTTTTTSSTTSSTTTTTTTTTTTTTTTTTTTTTTTTPPP
PPPTTTTTTTTSMSSSSSSSMSTTTTTTSSTAATTTSSSSSTSTTSSTSTTTTTTTTTTTTTTTTTTTSSTTSSTTTTTTTTTTTTTTTTTTTTTTTPPP
PPPTTTTTTTTSMSSSSSSSSSTTTTTTTSSAAKTTTTSTSSSSSSSSSSTTTTTTTTTTTTTTTTTSSTTSSSSTTTTTTTTTTTTTTTTTTTTTTPPP
PPPTTTTTTTTSMSSSSSSSMSTTTTTTSSTAATTTTTTTTSTSSTTSTSSTTTTTTTTTTTTTTTSSTTTTSSSSTTTTTTTTTTTTTTSSTTTSSPPP
PPPTTTTTTTTSMSSSSSSSMSTTTTTSSTAATTTTTTTTTTTTTTTTTTSSTTTSSTTTTTTTTTTSSTTTTSSTTTTTTTSSTSTTSSSSSTSSSPPP
PPPTTTTTTTTSMSSSSSSSMSTTTTTTSSTTTTTTTTTTTTTTTTTTTTTSSTSSSSTTTTTTTTTTTSTTSSSSSTSSTSSSSSSSSSTTSSSTTPPP
PPPTTTTTTTTSMSSSSSSSMSTTTTTTTSSTTTTTTTTTTTTTTTTTTTTTSSSTTSSTTSSSSTSSSSSSTSSSSSSSSSTTSTSSTTTTTSTTTPPP
PPPTTTTTTTTSMMMMMMMMMSTTTTTTSSTTTTTTTTTTTTTTTTTTTTTTTSTTTTSSSSSSSSSSSTSSSTSSTSTTSTTTTTTTTTTTTTTTTPPP
PPPTTTTTTTTSSSSSSSSSSSBBSSSSSSSSSSSTTTTTTTTTTTTTTTTTTTKTTTTSSTTTTSTTSSTTSSSTTTTTTTTTTTTTTTTTTTTTTPPP
PPPTTTTTTTTTTTTTTTBBBBBBSMMMMMMMMMSTTTTTTTTTTTTTTTTTTTTTTTTTSTTTSTTTSSTTTSSSTTTTTTTTSTTSSTTTTTTTTPPP
PPPTTTKTTTTTTTTTTTBBBBBBSMSSSSSSSMSTTTTTTTTTTTTTTTTTTTTTTTTSSSSSSSTSTSSSSSSSSTTTTTTSSSSSSSTTTTTTTPPP
PPPTTTTTTTTTTTTTTTBBBBBBSMSSSSSSSMSTTTTTTTTTTTTTTTTTTTTTTTSSTSSSBSSSSSBSSBSSSSBSSTSSTSSTTSSTSSTSSPPP
PPPTTTTTTTTTTTTTTTBBBBBBSMSSSSSSSSSTTTTTTTTTTTTTTTTTTTTSTSSTTTBBBBSBBSSBSBSSBSSSSSSTTTTTTTSSSSSSSPPP
PPPTTTTTTTTTTTTTTTBBBBBBSMSSSSSSSMSTTTTTTTTTTTTTTTSTTTSSSSTTTTBBBBBBBSSBBSSBBBSBTSTTTTTTTTTSTTSTTPPP
PPPTTTTTTTTTTTTTTTBBBBBBSMSSSSSSSMSTTTTTTTTTTTTTTSSSSSSTSTTTTTBBBBBBSSBBSSBBBBBBTTTTTTTTTKTTTTTTTPPP
PPPTTTTTTTTTTTTTTTBBBBBBSMSSSSSSSMSTTTTTTTTTTTTSSSTSSSTTTTTTTTBBBBBBSSBSSSSBBBBBTTTTTTTTTTTTTTTTTPPP
PPPTTTTTTTTTTTTTTTBBBBBBSMSSSSSSSMSTTTKTTTSSTSSSSTTTTTTTTTTTTTBBBBBSSBSSBSSBBBBBTTTTTTTTTTTTTTTTTPPP
PPPTTTTTTTTTTTTTTTBBBBBBSMMMMMMMMMSTTTTTTSSSSSSTTTTTTTTTTTTTTTBBBBBBBSSBSSBBBBBBTTTTTTTTTTTTTTTTTPPP
PPPTTTTTTTTTTTTTTTTTTTTTSSSSSSSSSSSSTTTSSSTTSTTTTKTTTTTTTTTTTTBBBBBBSSSSSSBBBBBBTTTTTTTTTTTTTTTTTPPP
PPPTTTTTTTTTTTTTTTTTTTTTTTTTSSTTTTSSSTSSSTTTTTTTTTTTTTTTTTTTTTBBBBBSSBBSSBBBBBBBTTTTTTTTTTTTTTTTTPPP
PPPTBBBBBBBBBBBBBBTSTSTTTSTSSAATSSSTSSSTTTTTTTTTTTTTTTTTTTTTTTBBBBBSSBSSSSBBBBBBTTTTTTTTTTTTTTTTTPPP
PPPTBBBBSBBBSSBBBBSSSSSTSSSSAASSSSTTTSTTTTTTTTTTTTTTTTTTTTTTTTBBBBBSSBBSSSSBBBBBTTTTTTTTTTTTTTTTTPPP
PPPTBBBSSSBSSSSBBSSTSTSSSSSAATSSTTTTTATTTTTTTTTTTTTTTTTTTTTTTTBBBBBSSBSSBSSBBBBBTTTTTTTTTTTTTTTTTPPP
PPPTSBSSBSSSBBSSSSTTTTTSSSTTAATTTTTTAAAATTTTTTTTTATTTTTTTTTTTTBBBBSSBSSBSSBBBBBBTTTTTTTTTTTTTTTTTPPP
PPPSSSSBBBSBBBBSSBTTTTTSSTAAAAATTATAATAAATTTTTTAAAATTTTTTTTTTTBBBBBSSSSBSSBBBBBBTTTTTTTTTTTTTTTTTPPP
PPPSBSBBBBBBABBBBBTATAATSSAATAAAAAAAKTTTAATTAAAAATAAAATTTTTTTABAABBBBSSSSBBBBBBBTTTTTTTTTTTTTTTTTPPP
PPPTBBBBBBBAAAABBAAAAAASSTTSSATAATATTTTTTAAAAAATTTTAAAAATTAAAAAAAABBSSSSSSBBSBBBTTTTTTTTTTTTTTTTTPPP
PPPTBBBBBAAABAAAAAATATTTTSSSSSTTTTTTTTTTTTAATTTTTTTTTTAATAAAATABBABBSSSSSSSSSSBATTSTTTTTTTTTTTTTTPPP
PPPTABAAAAABBBBAABTTTSTSSSSTTSSTTTTTTTTTTTTTTTTTTTTTTTTSSASTTTBBBBSSSSSSSSSSBSSASSSSTTATTTTTSTTTAPPP
PPPAAAAAABBBBBBBSSTSSSSSSTTTTTSSTTTTTTTTTTTTTTTTTTTTTSSSSSSSTSSSTSSSSSTSSTTTTTSSSSTSSSATTTTSSSTAAPPP
PPPABABBBBBBSSBSSSSSSTSTSSTTTAASSTTTTTTTTTTTTTTSTTTSSSSTTSTSSSSSSSTSSKSSTTTTTTTSTTTTSSSSSSSSTSSATPPP
PPPTBBBBBBSSSSSSBBSTTTTTSSTTAATTSSSTTTTTTTTSTSSSSSSSSTTTTTTTSTTTSTSSTTTSSTTTTTTTTTTTTTSSSSSTTTSSTPPP
PPPTBBBBBSSSBBSKBBTKTTTKTSSTTAATTSSSTSSTSSSSSSSTSSSTTTTTTTTTTTTTKTTSSTTTSSTTTTTTTTTTTTTTTTTTTTTSSPPP
PPPTSBBBSSBBBBBBBBTKTTTTSSTTAATTTTTSSSSSSSSTSTTTTTTTTTTTTTTTTTTTTTTSSTTTSSTTTTTTTKTTTTTTTTTTTTTTSPPP
PPPMMMMSMMMMMMMMMMMMMMMMMSSMAMMMMMMMMMMMMMMMMMMMMMMMMMMMMMMMMMMMMSSMMMMMMMMMMMMMMMMMMMMMMMMMMMMMMPPP
PPPSTSSSTTTTTTTTTTTTTTTTTSSTAATTTTTTTTTTTTTTTTTTTTTTTTTTTTTTTTTTTSSTTTTTSSTTTTTTTTTTTTTTTTTTTTTTTPPP
PPPTTTTTTTTTTTTTTTTTTTTTTSSAATTTTTTTTTTTTTTTTTTSSSSSSSSSSSTTTTTTTTSSTTTSSTTTTTTTTTTTTTTTTTTTTTTTTPPP
PPPTTTTTTTTTTTTTTTTTTTTTTSSTTTTTTTTTTTTTTTTTTTTSMMMMMMMMMSTTTTTTTTTSSTTTSSTTTTTTTTTTTTTTTTTTTTTTTPPP
PPPTTTTTTTTTTTTTTTTTTTTTTTSSTTTTTTTTTTTTTTTTTTTSMSSSSSSSMSTTTTTTTTTSSTTTSSTTTTTTTTTTTTKTTTTTTTTTTPPP
PPPTTTTTTTTTTTTTTTTTTTTTTTTSSTTTTTTTTAAAAAAAATTSMSSSSSSSMSTTTTTTTTTTSSTSSTTTTTTTTTTTTTTTTTTTTTTTTPPP
PPPTTTTTTTTTTTTTTTTTTTTTTTAASSTTTTTTTAAAAAAAATTSSSSSSSSSMSTTTTTTTTTTTSSTSSTTTTTTTTTTTTTTTTTTTTTTTPPP
PPPTTTTTTTTTTTTTTTTTTTTTTTTAASSTTTTTTAAAAAAAATTSMSSSSSSSMSTTTTTTTTTTSSTSSSSTTTTTTTTTTTTTTTTTTTTTTPPP
PPPTTTTTTTTTTTTTTTTTTTTTTTTTSSTTTTTTTAAAAAAAATTSMSSSSSSSMSTTTTTTTTTTSSTTSSSSTTTTTTTTTTTTTTTTTTTTTPPP
PPPTTTTTTTTTTTTTTTTTTTTTTTTSSTTTTTTTTAAAAAAAATTSMSSSSSSSMSTTTTTTTTTTTSSSSTSSTTTTTTTTTTTTTTTTTTTTTPPP
PPPTTTTTTTTTTTTTTTTTTTTTTTSSTTTTTTTTTAAAAAAAATTSMSSSSSSSMSTTTTTTTTTTTSSTTSSTTTTTTTTTTTTTTTTTTTTTTPPP
PPPTTTTTTTTTTTTTTTTTTTTTTTSSTTTTTTTTTAAAAAAAATTSMMMMMMMMMSTTTTTTTTTTTSSTTTSSTTTTTTTTTTTTTTTTTTTTTPPP
PPPTTTTTTTTTTTTTTTTTTTTTTTTSSTTTTTTTTAAAAAAAATTSSSSSSSSSSSTTTTTTTTTTSSSSTTSSTTTTTTTTTTTTTTTTTTTTTPPP
PPPTTTTTTTTTTTTTTTTTTTTTTTSSTTTTTTTTTTTTTTTTTTTTTTTTTTTTTTTTTTTTTTTTSSSSTSSTTTTTTTTTTTTTTTTTTTTTTPPP
PPPTTTTTTTTTTTTTTTTTTTTTTTTSSTTTTTTTTTTTTTTTTTTTTTTTTTTTTTTTTTTTTTTSSTSSSSTTTTTTTTTTTTTTTTTTTTTTTPPP
PPPTTTTTTTTTTTTTTTTKTTTTTTTTSSTTTTTTTTTTTTTTTTTTTTTTTTTTTTTTTTTTTTSSTSSTSSTTTTTTTTTTTTTTTTTTTTTTTPPP
PPPTTTTTTTTTTTTTTTTTTTTTTTTAASSTTTTTTTTTTTTTTTTTTTTTTTTTTTTTTTTTTTSSTSSSSTTTTTTTTTTTTTTTTTTTTTTTTPPP
PPPTTTTTTTTTTTTTTTTTTTTTTTTAASSTTTTTTTTTTTTTTTTTTTTTTTTTTTTTTTTTTTSSTTSSTTTTTTTTTTTTTTTTTTTTTTTTTPPP
PPPTTTTTTTTTTTTTTTTTTTTTTTTTSSTTTTTTTTTTTTTTTTKTTTTTTTTTTTTTTTTTTTTSSTSSTTTTTTTTTTTTTTTTTTTTTTTTTPPP
PPPPPPPPPPPPPPPPPPPPPPPPPPPPPPPPPPPPPPPPPPPPPPPPPPPPPPPPPPPPPPPPPPPPPPPPPPPPPPPPPPPPPPPPPPPPPPPPPPPP
PPPPPPPPPPPPPPPPPPPPPPPPPPPPPPPPPPPPPPPPPPPPPPPPPPPPPPPPPPPPPPPPPPPPPPPPPPPPPPPPPPPPPPPPPPPPPPPPPPPP
PPPPPPPPPPPPPPPPPPPPPPPPPPPPPPPPPPPPPPPPPPPPPPPPPPPPPPPPPPPPPPPPPPPPPPPPPPPPPPPPPPPPPPPPPPPPPPPPPPPP
